#map to show of water
00,00,00,00,00,00,00,00,00
00,11,11,11,11,11,11,11,00
00,11,11,11,11,11,11,11,00
00,11,01,11,11,11,01,01,00
00,01,01,11,11,01,01,01,00
00,01,01,01,01,01,03,01,00
00,01,03,01,03,01,01,01,00
00,01,01,01,01,01,01,01,00
00,00,00,00,00,00,00,00,00